{
	"LEVEL_NAME" : "big-ish 01",
	"GAME_MODE" : "Classic",
	"LEVEL_MATRIX" : [
		["93","80","10","10","10","10","10","10","10","24","10","10","10","10","10"],
		["80","61","80","10","90","10","10","10","10","10","10","63","10","90","10"],
		["10","80","34","10","23","10","90","10","10","10","10","10","10","10","10"],
		["10","10","10","10","10","10","10","13","10","10","10","10","10","10","10"],
		["10","10","19","20","70","50","12","11","14","52","10","73","10","10","10"],
		["10","10","54","10","10","10","10","83","10","10","10","10","10","10","10"],
		["10","10","10","10","64","10","10","10","10","10","10","43","10","10","10"],
		["10","10","10","00","00","00","00","00","00","00","00","00","10","10","10"],

		["10","10","10","00","10","23","10","00","10","33","10","00","10","10","10"],
		["10","10","22","00","23","21","23","00","33","31","33","00","32","10","10"],
		["10","10","10","00","10","23","10","73","10","33","10","00","10","10","10"],

		["10","10","10","00","00","00","43","51","53","00","00","00","10","10","10"],

		["10","10","10","00","10","43","10","63","10","53","10","00","10","10","10"],
		["10","10","42","00","43","41","43","00","53","51","53","00","52","10","10"],
		["10","10","51","00","10","43","10","13","10","53","10","00","10","10","10"],

		["10","10","10","00","00","00","23","51","33","00","00","00","10","10","10"],

		["10","10","10","00","10","63","10","83","10","73","10","00","10","10","10"],
		["10","10","62","00","63","61","63","00","73","71","73","00","72","10","10"],
		["10","10","10","00","10","63","10","00","10","73","10","00","10","10","10"],

		["10","10","10","00","00","00","00","00","00","00","00","00","10","10","10"],
		["10","10","10","10","10","10","10","10","10","10","10","10","10","10","10"],
		["10","10","10","10","10","10","10","10","10","10","10","10","10","10","10"],
		["10","10","10","10","10","10","10","10","10","10","10","10","10","10","10"],
	],
	"comment": [
		"WARNING: any of the YELLOW text below does not actually affect the game
		this is just so you can easily recognize what kind of tile you are making
		
		the first number defines the color. set a 0 to make a blank space
		0x: empty space    5x: yellow
		1x: gray           6x: purple
		2x: red            7x: orange
		3x: green          8x: black
		4x: blue           9x: RNG tile
		
		the second number is the attribute of the tile being placed
		x0: sets a regular tile
		x1: sets a bomb
		x2: sets a detonator
		x3: sets a box
		x4: sets a key
		x9: sets the player spawn point. (if there are multiple spawn points in a level, the last one will be used.)"
		],
}
